- - - # @ - - - # - 
- # # # # # # - # - 
- - # # - - - - - - 
# - # # - # # # # # 
# - # # - # - - - # 
- - - - - # # # - #
- # # # # # - - - - 
- # - - - # - # - # 
- # - # - # - # # - 
- - - # - - - - - -
# # # # - # # # - #

