###-#### 
$--#---- 
-#---#-# 
-#-###-- 
-#-#--#@
--##-#-# 
#------- 